border_size=1
usage=map

Gg          , Gg          , Gg          , Gg          , Gg          , Gg          , Gg          , Gg          , Gg          , Gg          , Gg          , Gg          , Gg          , Gg          , Gg          , Gg          , Gg          , Gg          , Gg          , Gg          , Gg          , Gg          , Gg          , Gg          , Gg          , Gg          , Gg          , Gg          , Gg          , Gg          , Gg          , Gg          , Gg          , Gg          , Gg          , Gg          , Gg          , Gg          , Gg          , Gg          , Gg          , Gg          , Gg          , Gg          , Gg          , Gg          , Gg          , Gg          , Gg          , Gg          , Gg          , Gg          , Gg          , Gg          , Gg          , Gg          , Gg          , Gg          , Gg          , Gg          , Gg          , Gg          
Gg          , Gg          , Gg          , Gg          , Gg          , Gg          , Gg          , Gg          , Gg          , Gg          , Gg          , Gg          , Gg          , Gg          , Gg          , Gg          , Gg          , Gg          , Gg          , Gg          , Gg          , Gg          , Gg          , Gg          , Gg          , Gg          , Gg          , Gg          , Gg          , Gg          , Gg          , Gg          , Gg          , Gg          , Gg          , Gg          , Gg          , Gg          , Gg          , Gg          , Gg          , Gg          , Gg          , Gg          , Gg          , Gg          , Gg          , Gg          , Gg          , Gg          , Gg          , Gg          , Gg          , Gg          , Gg          , Gg          , Gg          , Gg          , Gg          , Gg          , Gg          , Gg          
Gg          , Gg          , Xv          , Gg          , Xv          , Gg          , Xv          , Gg          , Gg          , Gg          , Gg          , Gg          , Gg          , Gg          , Xv          , Gg          , Gg          , Gg          , Xv          , Gg          , Gg          , Gg          , Xv          , Xv          , Xv          , Xv          , Xv          , Xv          , Xv          , Gg          , Xv          , Xv          , Xv          , Xv          , Xv          , Xv          , Xv          , Gg          , Gg          , Xv          , Xv          , Gg          , Gg          , Gg          , Xv          , Xv          , Gg          , Gg          , Gg          , 1 Gg        , Gg          , Gg          , Gg          , Gg          , Gg          , Gg          , Gg          , Gg          , Gg          , Gg          , Gg          , Gg          
Gg          , Gg          , Xv          , Xv          , Gg          , Xv          , Gg          , Xv          , Gg          , Xv          , Gg          , Gg          , Gg          , Gg          , Xv          , Gg          , Xv          , Xv          , Gg          , Xv          , Xv          , Gg          , Gg          , Gg          , Gg          , Xv          , Gg          , Gg          , Gg          , Gg          , Xv          , Gg          , Gg          , Gg          , Gg          , Gg          , Xv          , Gg          , Gg          , Xv          , Gg          , Xv          , Gg          , Xv          , Gg          , Xv          , Gg          , Gg          , Gg          , 2 Gg        , Gg          , Gg          , Gg          , Gg          , Gg          , Gg          , Gg          , Gg          , Gg          , Gg          , Gg          , Gg          
Gg          , Gg          , Xv          , Gg          , Gg          , Gg          , Gg          , Xv          , Gg          , Xv          , Gg          , Gg          , Gg          , Gg          , Xv          , Gg          , Xv          , Gg          , Gg          , Gg          , Xv          , Gg          , Gg          , Gg          , Gg          , Xv          , Gg          , Gg          , Gg          , Gg          , Xv          , Gg          , Gg          , Gg          , Gg          , Gg          , Xv          , Gg          , Gg          , Xv          , Gg          , Xv          , Xv          , Xv          , Gg          , Xv          , Gg          , Gg          , Gg          , 3 Gg        , Gg          , Gg          , Gg          , Gg          , Gg          , Gg          , Gg          , Gg          , Gg          , Gg          , Gg          , Gg          
Gg          , Gg          , Xv          , Gg          , Gg          , Gg          , Gg          , Gg          , Gg          , Xv          , Gg          , Gg          , Gg          , Gg          , Xv          , Gg          , Xv          , Gg          , Gg          , Gg          , Gg          , Gg          , Gg          , Gg          , Gg          , Xv          , Gg          , Gg          , Gg          , Gg          , Xv          , Gg          , Gg          , Gg          , Gg          , Gg          , Xv          , Gg          , Gg          , Xv          , Gg          , Gg          , Gg          , Gg          , Gg          , Xv          , Gg          , Gg          , Gg          , 4 Gg        , Gg          , Gg          , Gg          , Gg          , Gg          , Gg          , Gg          , Gg          , Gg          , Gg          , Gg          , Gg          
Gg          , Gg          , Xv          , Gg          , Gg          , Gg          , Gg          , Gg          , Gg          , Xv          , Gg          , Gg          , Gg          , Gg          , Xv          , Gg          , Gg          , Xv          , Xv          , Gg          , Gg          , Gg          , Gg          , Gg          , Gg          , Xv          , Gg          , Gg          , Gg          , Gg          , Xv          , Gg          , Gg          , Gg          , Gg          , Gg          , Xv          , Gg          , Gg          , Xv          , Gg          , Gg          , Gg          , Gg          , Gg          , Xv          , Gg          , Gg          , Gg          , 5 Gg        , Gg          , Gg          , Gg          , Gg          , Gg          , Gg          , Gg          , Gg          , Gg          , Gg          , Gg          , Gg          
Gg          , Gg          , Xv          , Gg          , Gg          , Gg          , Gg          , Gg          , Gg          , Xv          , Gg          , Gg          , Gg          , Gg          , Xv          , Gg          , Gg          , Gg          , Gg          , Xv          , Xv          , Gg          , Gg          , Gg          , Gg          , Xv          , Gg          , Gg          , Gg          , Gg          , Xv          , Gg          , Gg          , Gg          , Gg          , Gg          , Xv          , Gg          , Gg          , Xv          , Gg          , Gg          , Gg          , Gg          , Gg          , Xv          , Gg          , Gg          , Gg          , 6 Gg        , Gg          , Gg          , Gg          , Gg          , Gg          , Gg          , Gg          , Gg          , Gg          , Gg          , Gg          , Gg          
Gg          , Gg          , Xv          , Gg          , Gg          , Gg          , Gg          , Xv          , Gg          , Xv          , Gg          , Gg          , Gg          , Gg          , Xv          , Gg          , Xv          , Gg          , Gg          , Gg          , Xv          , Gg          , Gg          , Gg          , Gg          , Xv          , Gg          , Gg          , Gg          , Gg          , Xv          , Gg          , Gg          , Gg          , Gg          , Gg          , Xv          , Gg          , Gg          , Xv          , Gg          , Gg          , Gg          , Gg          , Gg          , Xv          , Gg          , Gg          , Gg          , 7 Gg        , Gg          , Gg          , Gg          , Gg          , Gg          , Gg          , Gg          , Gg          , Gg          , Gg          , Gg          , Gg          
Gg          , Gg          , Xv          , Xv          , Xv          , Xv          , Xv          , Xv          , Gg          , Xv          , Xv          , Xv          , Xv          , Xv          , Xv          , Gg          , Xv          , Gg          , Xv          , Gg          , Xv          , Gg          , Gg          , Gg          , Gg          , Xv          , Gg          , Gg          , Gg          , Gg          , Xv          , Gg          , Xv          , Gg          , Xv          , Gg          , Xv          , Gg          , Gg          , Xv          , Gg          , Gg          , Gg          , Gg          , Gg          , Xv          , Gg          , Gg          , Gg          , 8 Gg        , Gg          , Gg          , Gg          , Gg          , Gg          , Gg          , Gg          , Gg          , Gg          , Gg          , Gg          , Gg          
Gg          , Gg          , Gg          , Gg          , Gg          , Gg          , Gg          , Gg          , Gg          , Gg          , Gg          , Gg          , Gg          , Gg          , Gg          , Gg          , Gg          , Xv          , Gg          , Xv          , Gg          , Gg          , Gg          , Gg          , Gg          , Xv          , Gg          , Gg          , Gg          , Gg          , Gg          , Xv          , Gg          , Xv          , Gg          , Xv          , Gg          , Gg          , Gg          , Xv          , Gg          , Gg          , Gg          , Gg          , Gg          , Xv          , Gg          , Gg          , Gg          , 9 Gg        , Gg          , Gg          , Gg          , Gg          , Gg          , Gg          , Gg          , Gg          , Gg          , Gg          , Gg          , Gg          
Gg          , Gg          , Gg          , Gg          , Gg          , Gg          , Gg          , Gg          , Gg          , Gg          , Gg          , Gg          , Gg          , Gg          , Gg          , Gg          , Gg          , Gg          , Gg          , Gg          , Gg          , Gg          , Gg          , Gg          , Gg          , Gg          , Gg          , Gg          , Gg          , Gg          , Gg          , Gg          , Gg          , Gg          , Gg          , Gg          , Gg          , Gg          , Gg          , Gg          , Gg          , Gg          , Gg          , Gg          , Gg          , Gg          , Gg          , Gg          , Gg          , Gg          , Gg          , Gg          , Gg          , Gg          , Gg          , Gg          , Gg          , Gg          , Gg          , Gg          , Gg          , Gg          
Gg          , Gg          , Xv          , Gg          , Xv          , Gg          , Xv          , Gg          , Gg          , Gg          , Gg          , Gg          , Gg          , Gg          , Gg          , Gg          , Gg          , Gg          , Gg          , Gg          , Gg          , Gg          , Gg          , Gg          , Gg          , Gg          , Gg          , Gg          , Gg          , Gg          , Gg          , Gg          , Gg          , Gg          , Gg          , Gg          , Gg          , Gg          , Gg          , Gg          , Gg          , Gg          , Gg          , Gg          , Gg          , Gg          , Gg          , Gg          , Gg          , Gg          , Gg          , Gg          , Gg          , Gg          , Gg          , Gg          , Gg          , Gg          , Gg          , Gg          , Gg          , Gg          
Gg          , Gg          , Xv          , Xv          , Gg          , Xv          , Gg          , Xv          , Gg          , Gg          , Gg          , Gg          , Xv          , Xv          , Xv          , Gg          , Gg          , Gg          , Xv          , Gg          , Gg          , Gg          , Gg          , Gg          , Xv          , Gg          , Xv          , Xv          , Xv          , Xv          , Xv          , Gg          , Gg          , Gg          , Xv          , Xv          , Xv          , Gg          , Gg          , Gg          , Xv          , Xv          , Xv          , Xv          , Xv          , Gg          , Xv          , Xv          , Xv          , Xv          , Xv          , Gg          , Gg          , Xv          , Xv          , Gg          , Gg          , Gg          , Gg          , Xv          , Gg          , Gg          
Gg          , Gg          , Xv          , Gg          , Gg          , Gg          , Gg          , Xv          , Gg          , Gg          , Gg          , Xv          , Gg          , Gg          , Gg          , Xv          , Gg          , Gg          , Xv          , Xv          , Xv          , Gg          , Xv          , Xv          , Xv          , Gg          , Xv          , Gg          , Gg          , Gg          , Xv          , Gg          , Gg          , Xv          , Gg          , Gg          , Gg          , Xv          , Gg          , Gg          , Gg          , Gg          , Xv          , Gg          , Gg          , Gg          , Xv          , Gg          , Gg          , Gg          , Gg          , Xv          , Gg          , Xv          , Gg          , Xv          , Gg          , Gg          , Gg          , Xv          , Gg          , Gg          
Gg          , Gg          , Xv          , Gg          , Gg          , Gg          , Gg          , Gg          , Gg          , Gg          , Gg          , Xv          , Gg          , Gg          , Gg          , Xv          , Gg          , Gg          , Xv          , Gg          , Xv          , Gg          , Xv          , Gg          , Xv          , Gg          , Xv          , Gg          , Gg          , Gg          , Xv          , Gg          , Gg          , Xv          , Gg          , Gg          , Gg          , Xv          , Gg          , Gg          , Gg          , Gg          , Xv          , Gg          , Gg          , Gg          , Xv          , Gg          , Gg          , Gg          , Gg          , Gg          , Gg          , Xv          , Gg          , Xv          , Gg          , Gg          , Gg          , Xv          , Gg          , Gg          
Gg          , Gg          , Xv          , Gg          , Gg          , Gg          , Gg          , Gg          , Gg          , Gg          , Xv          , Xv          , Xv          , Xv          , Xv          , Xv          , Xv          , Gg          , Xv          , Gg          , Gg          , Xv          , Gg          , Gg          , Xv          , Gg          , Xv          , Gg          , Xv          , Gg          , Xv          , Gg          , Xv          , Xv          , Xv          , Xv          , Xv          , Xv          , Xv          , Gg          , Gg          , Gg          , Xv          , Gg          , Gg          , Gg          , Xv          , Gg          , Gg          , Gg          , Xv          , Gg          , Gg          , Xv          , Gg          , Xv          , Xv          , Gg          , Gg          , Xv          , Gg          , Gg          
Gg          , Gg          , Xv          , Gg          , Gg          , Gg          , Gg          , Gg          , Gg          , Gg          , Xv          , Gg          , Gg          , Gg          , Gg          , Gg          , Xv          , Gg          , Xv          , Gg          , Gg          , Gg          , Gg          , Gg          , Xv          , Gg          , Xv          , Xv          , Gg          , Xv          , Gg          , Gg          , Xv          , Gg          , Gg          , Gg          , Gg          , Gg          , Xv          , Gg          , Gg          , Gg          , Xv          , Gg          , Gg          , Gg          , Xv          , Gg          , Gg          , Xv          , Gg          , Xv          , Gg          , Xv          , Gg          , Gg          , Gg          , Xv          , Gg          , Xv          , Gg          , Gg          
Gg          , Gg          , Xv          , Gg          , Gg          , Gg          , Gg          , Xv          , Gg          , Gg          , Xv          , Gg          , Gg          , Gg          , Gg          , Gg          , Xv          , Gg          , Xv          , Gg          , Gg          , Gg          , Gg          , Gg          , Xv          , Gg          , Xv          , Gg          , Gg          , Gg          , Gg          , Gg          , Xv          , Gg          , Gg          , Gg          , Gg          , Gg          , Xv          , Gg          , Gg          , Gg          , Xv          , Gg          , Gg          , Gg          , Xv          , Gg          , Gg          , Gg          , Gg          , Xv          , Gg          , Xv          , Gg          , Gg          , Gg          , Xv          , Gg          , Xv          , Gg          , Gg          
Gg          , Gg          , Xv          , Xv          , Xv          , Xv          , Xv          , Xv          , Gg          , Gg          , Xv          , Gg          , Gg          , Gg          , Gg          , Gg          , Xv          , Gg          , Xv          , Gg          , Gg          , Gg          , Gg          , Gg          , Xv          , Gg          , Xv          , Gg          , Gg          , Gg          , Gg          , Gg          , Xv          , Gg          , Gg          , Gg          , Gg          , Gg          , Xv          , Gg          , Xv          , Xv          , Gg          , Xv          , Xv          , Gg          , Xv          , Xv          , Xv          , Xv          , Xv          , Xv          , Gg          , Xv          , Gg          , Gg          , Gg          , Xv          , Xv          , Xv          , Gg          , Gg          
Gg          , Gg          , Gg          , Gg          , Gg          , Gg          , Gg          , Gg          , Gg          , Gg          , Gg          , Gg          , Gg          , Gg          , Gg          , Gg          , Gg          , Gg          , Gg          , Gg          , Gg          , Gg          , Gg          , Gg          , Gg          , Gg          , Gg          , Gg          , Gg          , Gg          , Gg          , Gg          , Gg          , Gg          , Gg          , Gg          , Gg          , Gg          , Gg          , Gg          , Gg          , Gg          , Gg          , Gg          , Gg          , Gg          , Gg          , Gg          , Gg          , Gg          , Gg          , Gg          , Gg          , Xv          , Gg          , Gg          , Gg          , Gg          , Gg          , Xv          , Gg          , Gg          
Gg          , Gg          , Gg          , Gg          , Gg          , Gg          , Gg          , Gg          , Gg          , Gg          , Gg          , Gg          , Gg          , Gg          , Gg          , Gg          , Gg          , Gg          , Gg          , Gg          , Gg          , Gg          , Gg          , Gg          , Gg          , Gg          , Gg          , Gg          , Gg          , Gg          , Gg          , Gg          , Gg          , Gg          , Gg          , Gg          , Gg          , Gg          , Gg          , Gg          , Gg          , Gg          , Gg          , Gg          , Gg          , Gg          , Gg          , Gg          , Gg          , Gg          , Gg          , Gg          , Gg          , Gg          , Gg          , Gg          , Gg          , Gg          , Gg          , Gg          , Gg          , Gg          
