Xos, Xos, Xos, Xos, Xos, Xos, Xos, Xos, Xos, Xos^Efs, Xos^Efs, Xos, Xos^Efs, Xos^Efs, Xos, Xos, Xos, Xos, Xos, Xos, Xos, Xos, Xos
Wo^Xo, Wo^Xo, Wo^Xo, Xv, Wo^Xo, Wo^Xo, Wo^Xo, Xv, Wo^Xo, Wo^Xo, Wo^Xo, Wo^Xo, Wo^Xo, Wo^Xo, Wo^Xo, Xv^Vov, Wo^Xo, Wo^Xo, Wo^Xo, Xv, Wo^Xo, Wo^Xo, Wo^Xo
Wo^Xo, Wo^Xo, Wo^Xo, Xv, Wo^Xo, Wo^Xo, Wo^Xo, Xv, Wo^Xo, Wo^Xo, Wo^Xo, Xv, Wo^Xo, Wo^Xo, Wo^Xo, Xv, Wo^Xo, Wo^Xo, Wo^Xo, Xv, Wo^Xo, Wo^Xo, Wo^Xo
Wo^Xo, Wo^Xo, Wo^Xo, Wo^Xo, Wo^Xo, Wo^Xo, Wo^Xo, Wo^Xo, Wo^Xo, Wo^Xo, Wo^Xo, Wo^Xo, Wo^Xo, Wo^Xo, Wo^Xo, Wo^Xo, Wo^Xo, Wo^Xo, Wo^Xo, Wo^Xo, Wo^Xo, Wo^Xo, Wo^Xo
Wo^Xo, Ce, Ce, Ce, Ce, Ce, Ce, Ce, Ce, Wo^Xo, Wo^Xo, Wo^Xo, Wo^Xo, Wo^Xo, Ch, Ch, Ch, Ch, Ch, Ch, Ch, Ch, Wo^Xo
Wo^Xo, Ce, Ce, Ce, Ce, Ce, Ce, Ce, Ce, Wo^Xo, Kh, Kh, Kh, Ch, Ch, Ch, Ch, Ch, Ch, Ch, Ch, Ch, Wo^Xo
Wo^Xo, Ce, Ce, Ce, Ce, Ce, Ce, Ce, Ce, Wo^Xo, Kh, 1 Kh, Kh, Ch, Ch, Ch, Ch, Ch, Ch, Ch, Ch, Ch, Wo^Xo
Wo^Xo, Ce, Ce, Ce, Ce, Ce, Ce, Ce, Ce, Wo^Xo, Ch, Kh, Ch, Ch, Ch, Ch, Ch, Ch, Ch, Ch, Ch, Ch, Wo^Xo
Wo^Xo, Ce, Ce, Ce, Ce, Ce, Ce, Ce, Ce, Wo^Xo, Ch, Ch, Ch, Ch, Ch, Ch, Ch, Ch, Ch, Ch, Ch, Ch, Wo^Xo
Wo^Xo, Ce, Ce, Ce, Ce, Ce, Ce, Ce, Ce, Wo^Xo, Ch, Ch, Ch, Ch, Ch, Ch, Ch, Ch, Ch, Ch, Ch, Ch, Wo^Xo
Wo^Xo, Ce, Ce, Ce, Ce, Ce, Ce, Ce, Ce, Wo^Xo, Ch, Ch, Ch, Ch, Ch, Ch, Ch, Ch, Ch, Ch, Ch, Ch, Wo^Xo
Wo^Xo, Ce, Ce, Ce, Ce, Ce, Ce, Ce, Ce, Wo^Xo, Ch, Ch, Ch, Ch, Ch, Ch, Ch, Ch, Ch, Ch, Ch, Ch, Wo^Xo
Wo^Xo, Ce, Ce, Ce, Ce, Ce, Ce, Ce, Ce, Wo^Xo, Ch, Ch, Ch, Ch, Ch, Ch, Ch, Ch, Ch, Ch, Ch, Ch, Wo^Xo
Wo^Xo, Ce, Ce, Ce, Ce, Ce, Ce, Ce, Ce, Wo^Xo, Ch, Ch, Ch, Ch, Ch, Ch, Ch, Ch, Ch, Ch, Ch, Ch, Wo^Xo
Wo^Xo, Ce, Ce, Ce, Ce, Ce, Ce, Ce, Ce, Wo^Xo, Ch, Ch, Ch, Ch, Ch, Ch, Ch, Ch, Ch, Ch, Ch, Ch, Wo^Xo
Wo^Xo, Ce, Ce, Ce, Ce, Ce, Ce, Ce, Ce, Wo^Xo, Ch, Ch, Ch, Ch, Ch, Ch, Ch, Ch, Ch, Ch, Ch, Ch, Wo^Xo
Wo^Xo, Ce, Ce, Ce, Ce, Ce, Ce, Ce, Ce, Wo^Xo, Ch, Ch, Ch, Ch, Ch, Ch, Ch, Ch, Ch, Ch, Ch, Ch, Wo^Xo
Wo^Xo, Ce, Ce, Ce, Ce, Ce, Ce, Ce, Ce, Wo^Xo, Ch, Ch, Ch, Ch, Ch, Ch, Ch, Ch, Ch, Ch, Ch, Ch, Wo^Xo
Wo^Xo, Ce, Ce, Ce, Ce, Ce, Ce, Ce, Ce, Wo^Xo, Ch, Ch, Ch, Ch, Ch, Ch, Ch, Ch, Ch, Ch, Ch, Ch, Wo^Xo
Wo^Xo, Ce, Ce, Ce, Ce, Ce, Ce, Ce, Ce, Wo^Xo, Ch, Ch, Ch, Ch, Ch, Ch, Ch, Ch, Ch, Ch, Ch, Ch, Wo^Xo
Wo^Xo, Ce, Ce, Ce, Ce, Ce, Ce, Ce, Ce, Wo^Xo, Ch, Ch, Ch, Ch, Ch, Ch, Ch, Ch, Ch, Ch, Ch, Ch, Wo^Xo
Wo^Xo, Wo^Xo, Wo^Xo, Wo^Xo, Wo^Xo, Wo^Xo, Wo^Xo, Wo^Xo, Wo^Xo, Wo^Xo, Wo^Bw|, Wo^Xo, Wo^Bw|, Wo^Xo, Wo^Xo, Wo^Xo, Wo^Xo, Wo^Xo, Wo^Xo, Wo^Xo, Wo^Xo, Wo^Xo, Wo^Xo
